Chiedere – to ask
Tipo – such as
Abbastanza – enough
Stamattina – this morning
Prendere – to take
Portare – to carry
Insegnante – teacher
Curare – to cure
Usare – to use
Indirizzo – address
Punto – dot 
Chiocciola - @
Campanella – bell
Operaio – worker
Cameriere – waiter
Sposato – married to
Diverso – different
Ogni – every
Come ti – like you
Pigro – lazy
Senza – without
Fuori – out
Dentro –  Inside 
Zittire – silence
Gusto - Taste   
Consigliare – to recommend
Lento – slow
Potere – can
Volere – to want
A volte – sometimes
Facile – easy
Veloce – fast
Dormire – to sleep
Dare – to give
Partire – leave
Dimenticare – to forget
Posto – place
Invece – instead
Spiegare – to explain
Mettere – to put
Aggiungere – to add
Mente – mind
Tenere – to keep
Se – if
Credere -  to believe
Fra – between
Saltare – to jumb
Strana - Strange
Testa – head
Lacrima – tear
Stella – star
Bocca – mouth
Diventare – to become
Seguire – to follow
Ricordare – to remember
Spesso – often
Semplice – simple
Piatto – plate
Cucchiaio – spoon
Coltello – knife
profondo – deep
piano – flat
imparare – to learn
forchetta – fork
tazza- cup
borsa – bag
davanti a – in front of
accanto a – next to
aiuto – help
insieme – together
dietro di – behind
tovagliolo – napkin
giocatore – player
pallacanestro – basketball
stesso – same
scarpe – shoes
decidere – to decide
nascere – to be born
perdere – to lose
rimanere – to stay
fermare – to stop
cadere – to fall
sembra-to seem
magro – thin
torre – tower
misura – measure, size
piovere – to rain
colpa – fault
È colpa mia – it’s my fault
Pesante – heavy
Umore - mood
Leggero – light
Bevanda – beverage
Scelta – choice
Contrattare - შევაჭრება
Sicuro – safe
Spesso – often
Taglia – size
Subito – right away
Vestito – dress
Scarpe – shoes
Maglietta – t-shirt
Pantaloni – pants
Marrone – brown
Giallo – yellow
Grigio – grey
Verde – green
Viola – violet
Blu – blue
Riga – line
Indossare – to wear
Chiaro – clear
Certo – certainly
Cominciare – to start
Largo – wide
Assaggiare – to taste
Pesare – to weigh
Vuoto – empty
Pieno -full
Sbagliato- wrong
Luogo – place
Dannoso – harmful
Utile – useful
Pericoloso - საშიში
Non solo ---- ma anche ----
Metà - half
Principale – main
Per questo – that’s because
Godere – to enjoy
Sotto – under
Ronpere – to break
Soddisfatto – satisfied
Nessuno – nobody
Campagna – countryside
Comunque – anyways
Aprire – to open
Partire – to leavef
Ponte – bridge
Grattacieli – skyscraper
Accendere – to turn on
Cervello – brain
A piedi – on foot
Salire - ასვლა
Scendere - ჩასვლა
Poi – then
Caricatore – charger
Mezzanotte – midnight
Alzarsi – to get up
Vestirsi – to get dressed
Lavarsi I denti – to brush teeth
Svegliarsi - გაღვიძება
Farsi la doccia - დუში
Restare – to stay
Tornare – to come back
Compiti – homework
Dopo – after
Tranne – except
Mai – never
Prima – before
Arrabbiarsi – to get angry
piangere – to cry
Rilassarsi – to relax
Giocare – to play
Barca – boat
Allenarsi – to train
Avventura – adventure
Vincere – to win
Unire – to unite
Tagliare – to cut
Pulire – to clean
Faticoso – tiring
Schiena - ზურგი
Freddo – cold
Anziano – elderly
Braccio – arm
Guadagnare – earn
Lontano – distant
Meraviglioso – wonderful
Racconto – story
all'inizio – at the start
davvero -really 
mal di testa – headache
dimenticare – to forget
consiglio – advice
fretta – rush
evitare – to avoid
smettere – to stop
proprio – own
dappertutto – everywhere
oppure – or
sperare – to hope
scoprire – discover
diligente - ბეჯითი
forte - strong
debole – weak
pieno – full
vuoto – empty
duro – hard
morbido – soft
zanzara – mosquito
mosca – fly
formica – ant
farfalla – butterfly
coccinella – ladybug
l’ape – bee
le forbici - scissors
il pettine – comb
ammettere - აღიარება
qualsiasi ნებისმიერი
notare – to note
Sono d'accordo con te – I agree with you
discorso – conversation
breve – short
soprattutto – especially
piscina – pool
impegnato - დაკავებული
suonare – play the instrument
fidanzato – fiancee
sano – healthy
abbinare – to match
addormentarsi – to fall asleep
truccarsi – to put on makeup
baciarsi – to kiss
Collegare – to connect
togliersi le scarpe – take off the shoes
annoiarsi – to get bored
mettersi – to put on
divertirsi – to have fun
spogliarsi – undress
freccia – arrow
salutarsi – to say goodbye
pittore – painter
casalinga – housewife
dipingere – to paint
scegliere – to choose
toccare – to touch
bagnato - wet
asciutto – dry
sono capace di – I am capable of 
onesta – honest
verita - სიმართლე
la patente – driver’s license
sciare – to ski
loquace – ყბედი
chiacchierone - ყბედი formal
edificio – building
scherzare – to joke
perdonare – to forgive
guidare – to drive
ottenere – to obtain
iscriversi – to sign up
occhiali - სათვალეები
un colloquio di lavoro – jobinterview
sorridere – to smile
abbigliamento – clothing
stretto - ვიწრო
straordinaria – molto speciale
fare la spesa – for buying food
rubare – to steal
spiaggia – beach
Inverno – winter
La neve – snow
Fa freddo/fa caldo - ცივა
Spegnere – to turn off
Accendere – to turn on
l'estate scorsa – last summer
un sacco - a lot
lavare – to wash
brindare – to drink a toast
guancia – cheek
paio – pair
battere – დაამარცხა
spedire – to send
ammirare – to admire
affascinare – fascinate
incontaminato - ახალთახალი pristine
spaziare – to wander
quali lo – such as
permettere – to allow
spettacolo – show 
indimenticabilo – unforgettable
risalenti – dating back
magno – great
assieme – together with
colpire – to hit
Soffiare – to blow
Gettare – to throw
Gettare la spazzatura – to throw away the rubbish
Buttare la spazzatura
Palla – ball
Ognuno di noi – each of us
Slitta - ციგა
babbo natale - თოვლის პაპა
il carbone - ნახშირი
scopa - ცოცხი
candela – candle
riquardo – box
festeggiare – to celebrate
valore – value
festività - დღესასწაული
legare – to tie	
dono – gift
affondare – to sink
si tratta – it deals with
all’estero – abroad
manzo – beef
scolare – to drain
tovaglia - სუფრა
pasto – meal
In sintesi – in summary
Collo - neck
Collana – necklace
Deluso – disappointed
Spaventato – scared
Mandare – to send
Ladro - ქურდი
Dirigente – manager
Disabitati - დაუსახლებელი
Alba - მზის ამოსვლა
Sorgere – to rise
Attendere – to wait for
un’immagine - ფოტო
è vestito di nero - შავებშია ჩაცმული
bottega – shop
divieto – prohibition
ripasso – reviews
fetta – slice
versare – to pour
frutta – fruit
verdura – vegetables
risparmiare I soldi – necessario
riempire – to fill 
sacchetto - პარკი
in contanti – in cash
affrontare – to face
cappoto - coat
I calzini - socks
Pentola - ქვაბი
Pandella - ტაფა
Cestino – basket
Uguale  - equally
Imbarazzante – embarassing
Ospite – guest
Maleducato – rude
Ghiaccio – ice
Gomma – eraser
Righello – ruler
Carta – paper
Accettare – to accept
Consentire – to allow
Portare – to bring
Amicizia - friendship
Rispetto – respect
Fidarsi – to trust
Supporto – support
Condividere – to share
Buio – dark
ti auguro - გისურვებ
scontro – clash
successiva – following
si svolge – takes place
in orario – on time
vado da Marco - მარკოსთან მივდივარ
smettere- quit
mostrare – to show
richiedere – to request
contro – against
squadra – team
risultato – result
insomma – in short
dunque – therefore
partita – match
riferire – to report
notizia – news
prevedere – to foresee
gara -  competition
intanto – In the meantime
nulla – nothing
sindaco – mayor
vittima – victim
avvenire – to happen
rete – net
indagine – investigation
nota – note
ferito – wounded
infine – in the end
ormai – at this point
ripresa – recovery
paura – fair
tifoso – fan
sfida – challenge
dubbio – doubt
rendere – to give back
calo – decrease, drop
difesa – defence
danno – damage
fonte – source
controllare – to check
ragione – reason
vicenda – event
cittadino – citizen
grave – serious
bilancio – balance
anzi – on the contrary
fino – until
fondo – bottom
attesa – wait
linea – line
fiducia – trust
sogno – dream
affermare – to assert
crescita – growth
diritto – the right side
entro – within
maggioranza – majority
discorso – speech
bollire – to boil
friggere – to fry
arma – weapon
non ne posso piu – 
tramite - through (by)
inviare - to send
denaro - money
fila - row (რიგი)
frequentare -
compagno - mate
estivo - ზაფხულის
approfondire - go into detail
sondaggio - survey
percorso - path
argomento - საკითხი
ovunque - ყველგან
partenza - departure
ognuno - everyone
chiunque - anyone
malato - sick
gridare - to shout
sussurrare - to whisper
ricevere - to recieve
spaventoso - frightening
coda - tail
capo - boss
schermo - screen
A proposito - by the way
suono - sound
rialzo - rise
accadere - to happen
scattare - take a picture
indagare - to investigate
pure - also
confronto - comparison
segno - sign
corsa - race
arrestare - to stop
richiesta - request
formazione - education
presto - soon
ruolo - role
termine - end
proseguire - to continue
denuncia - complaint
riprendere - get back, resume
entrambi - both
coppia - couple
inchiesta - investigation
denunciare - to report
sviluppo - development
soltanto - only
contare - to count
ottimo - very good
gratuito - free
spesa - expense
battaglia - battle
apparire - to appear
quotidiano - daily
giudice - judge
speranza - hope
nemmeno - not even
provvedimento - measure
sconfitta - defeat
disponibile - availabe
pericolo - danger
dichiarare - to declare
parere - to seem
valere - to be worth
recuperare - to recover
rapire - to kidnap
sdraiarsi - to lie down
sopravvivere - to survive
attualmente - currently
svolgere - carry out
eppure - and yet, but yet
serio - serious
solito - usual
risalire - date back to 
occorrere - to be required
trattativa - negotiation
fissare - to set, fixate on
terminare - to end
lotta - struggle
precedente - previous
droga - drug
segnare - to mark
fermo - fixed
appunto - precisely
avvio - start
avversario - opponent
previsione = forecast
rappresentare - represent
cedere - to surrender
migliorare - to improve
cacciare - to hunt
soccorso - rescue
piuttosto - rather
appena - just
altrimenti - otherwise-
fuga - escape
rifiuto - rejection
volo - flight
disagio - discomfort
ritardo - delay
terremoto - earthquake
porre - to put
sangue - blood
ritiro - withdrawal
grosso - big
sala - room
tale - such
preoccupazione - worry
quota - amount
popolo - people
effettuare - to make
ulteriore - further
furto - theft
meritare - to deserve
ribasso - depreciation
rientrare - return
contento - pleased
terreno - ground
contenuto - content
familiare - relative
guardia - guard
prestazione - performance
affare - business, matter
ritrovare - to find
sanità - healthcare
giungere - to come
regia - direction
scudetto - championship
tappa - stage
smentire - to deny
pensiero - thought
mantenere - to keep
neppure - not even
tassa - tax
né - neither ... nor
accertamento - verification
chiarire - to clarify
incendio - fire
intero - entire
convegno - meeting
orgoglioso - proud
schifo - disgust
ramo - branch
Sebbene - although
trascinare - to drag
soffitto - ceiling
tappeto - carpet
tenda - curtain
cuscino - pillow
asciugamano - towel
comportamento - behavior
coprire - to cover
zampa - paw
il bastone - stick
qualunque - anyone
articolo - item
sistemare - to tidy up, fix
brivido - shiver
recinzione - fence
fiero di - proud of
stupire - to amaze
rafforzare - to strengthen
schiacciare - to squash
finché - till
poltrona - armchair
affogare - to drown
ringraziare - to thank
tesoro - treasure
magazzino - warehouse
illeso - unharmed
infrangere - to break
tuono - thunder
tempesta - storm
inseguire - to chase
fantasma - ghost
annegare - to drown
risparmiare - to save
lampo - lightning
riposare - to rest
catena - chain
unirsi - to join
contenere - to contain
impiegare - to use
occhiata - look
mittente - sender
successivo - following
paragonare - to compare
rendere - to make
precedente - previous
pertanto - therefore
nuovamente - again
attenuare - to mitigate
respingere - to reject
rallentare - to slow down
assicurarsi - to make sure
spostare - to move
intrappolato - trapped
convenire - to aggree, to suit
trappola - trap
perciò - therefore
tesa - tense
Ad eccezione di - except
ce n’è una - there is one
infilare - to insert
vergogna - shame
titubante - reluctant
ramazi da zuka































































cortese - polite
sostituire - to replace
augurare - i wish that
voto - mark
stesura - drafting
prestare - to lend
scommettere - to bet
rimpiazzare - to replace
consegnare - to deliver
me ne rendo conto - i realise
All’improvviso - suddenly
solo poco tempo fa - only recently
Riassunto - summery
tirare - to pull
tiepide - warm
collina -hill
pelosa - furry
pertinente - relevant
volontà - will
ha qualcosa a che fare con - has something to do
farò del mio meglio - i will do my best
compreso - included
lamentarsi - to complain
abituarsi a - to get used to
cominciare con - 
cominciare a - 
aiutare a - 
chiedere di -
sapere di - 
temere di - 
riuscire a -
cercare di - to try to
dimenticarsi di - 
dubitare di - 
continuare a - 
domandare di -
finire di -
avrei dovuto andare - we should have gone
dispiacersi di -
finire per -
dire di -
restare/rimanere a -
permettersi di -
pregare di - to beg
stare a -
stare per -
divertirsi a -
sognare di - to dream
mettersi a - to get myself
insegnare a - 
sponda - shore
approfittare - to take advantage of
sentiero - path
bosco - woods
condurre - to lead
spaccare - to break
sosta - stop
spalla - shoulder
bugia - lie
sfuggirsi - to escape
Scomparire - to disappear
proporre - to propose






 






